1
=============
=  X  ==    =
= =  B      =
=  ==== O B =
= ==O       =
=============
2
=============
=  X  === B =
= =  B      =
=  ==== O B =
= ==O    O  =
=============
3
========
=X  B O=
= = O===
= B  ===
=      =
========
4
========
=X B O =
========
5
========
=O B  X=
========
