1
=============
=  X  ==    =
= =  B      =
=  ==== O B =
= ==O       =
=============
2
=============
=  X  === B =
= =  B      =
=  ==== O B =
= ==O    O  =
=============