=============
=  X  ===   =
= =  B      =
=  ==== O B =
= ==O       =
=============